16 10
000 000 000 030 000 000 000 000 000 000 000 000 000 000 000 060
081 132 153 030 000 000 000 000 000 000 000 000 000 000 000 000
000 000 000 030 000 000 010 000 000 000 000 000 000 000 000 000
000 000 000 030 000 000 000 000 000 000 000 000 020 000 000 000
000 000 000 030 000 000 000 000 000 000 000 000 060 000 000 000
071 132 163 030 000 000 000 000 000 000 000 000 000 000 000 000
071 142 111 030 000 000 000 000 050 000 000 000 000 000 000 000
000 000 000 030 000 000 000 000 000 000 000 000 060 000 000 000
000 000 000 030 000 000 000 000 000 000 000 000 000 000 000 000
000 000 000 030 000 000 000 000 000 000 000 000 000 000 000 000
