23 14
060 060 000 000 000 000 000 000 000 000 000 030 000 000 000 000 000 000 000 000 000 000 000
060 060 000 000 000 000 000 000 000 000 000 030 000 000 000 000 000 000 000 000 000 000 000
060 060 000 000 000 000 000 000 000 000 000 030 000 000 000 000 000 000 000 000 000 000 000
060 060 000 000 000 000 000 000 000 000 000 030 000 000 000 000 060 000 000 060 000 000 000
060 060 060 000 000 000 000 000 000 000 000 030 000 000 000 000 000 000 000 000 000 000 000
060 060 060 000 071 132 163 000 000 000 000 030 000 000 000 000 000 000 000 000 000 060 000
060 060 060 060 000 000 000 000 000 000 000 030 000 000 000 060 000 010 000 000 000 000 000
060 060 060 060 091 132 183 000 000 000 000 030 000 000 000 000 000 000 000 000 000 000 000
060 060 060 060 000 000 000 000 000 000 000 030 000 000 000 000 000 000 000 000 000 000 000
060 060 000 000 111 132 153 000 000 000 000 030 000 000 000 000 000 050 000 000 000 000 000
060 060 000 000 000 000 000 000 000 000 000 030 000 000 000 000 000 000 000 000 000 000 000
060 060 000 000 081 132 183 000 000 000 000 030 000 000 000 000 000 000 000 000 000 000 000
060 060 000 000 000 000 173 000 000 000 000 030 000 000 000 000 000 000 000 000 000 000 000
060 060 000 000 000 000 000 000 000 000 000 030 000 000 000 000 000 000 000 000 000 000 000