23 13
000 000 000 000 000 000 000 000 000 010 010 010 010 010 010 010 010 010 010 010 010 000 000
000 000 000 000 000 000 000 000 000 010 000 000 000 000 000 000 000 000 000 000 010 000 000
000 000 000 000 000 000 000 000 010 010 000 000 000 000 000 000 000 000 000 000 010 000 000
000 000 000 000 010 010 010 010 010 132 000 000 000 000 000 153 000 000 000 000 010 000 000
000 000 000 000 010 000 000 000 000 000 000 000 000 000 000 000 000 000 000 010 000 000 000
000 000 000 000 010 000 000 000 000 000 000 000 000 000 000 000 000 000 000 000 000 000 000
000 000 000 000 010 000 000 000 000 000 000 000 050 000 000 000 000 000 000 000 010 000 000
000 000 000 000 010 111 010 010 010 010 010 010 010 010 010 010 010 010 010 010 010 000 000
000 000 000 000 000 000 000 000 000 010 000 000 000 000 000 000 000 000 000 000 010 000 000
000 000 000 000 000 000 000 000 000 010 000 000 000 000 000 000 000 000 000 000 010 000 000
000 000 071 000 000 000 000 000 000 010 000 000 000 000 000 000 000 000 000 000 010 000 000
000 000 132 000 000 000 000 000 000 010 000 000 000 000 000 000 000 000 000 000 010 000 000
000 000 163 000 000 000 000 000 000 010 010 010 010 010 010 010 010 010 010 010 010 000 000
