23 13
101 132 193 030 000 000 000 000 000 000 000 000 000 000 000 000 000 000 000 030 010 040 010
030 030 030 030 000 000 000 000 000 000 000 000 000 000 000 000 000 000 000 030 040 050 040
000 000 010 000 000 000 000 000 010 010 010 000 000 000 000 000 000 000 000 030 010 040 010
000 000 000 000 000 000 000 000 000 101 000 000 000 000 000 000 000 000 000 030 030 030 030
000 000 071 000 000 000 000 000 000 000 000 000 000 000 000 000 000 000 000 000 000 000 000
010 000 132 030 000 000 000 000 000 000 000 000 000 000 000 000 000 000 000 000 000 000 000
010 000 163 030 000 000 010 000 000 000 000 000 000 000 000 000 000 000 000 000 000 000 000
000 000 030 030 000 000 010 000 000 010 000 010 000 000 000 000 000 000 000 000 000 000 000
010 000 000 000 000 000 010 000 000 000 000 000 000 000 000 000 000 010 010 000 000 000 000
000 000 000 010 000 000 000 010 000 000 000 000 000 000 000 010 000 000 000 010 000 000 000
000 000 000 000 000 000 010 000 000 000 000 000 000 000 000 010 000 000 000 000 000 000 000
030 030 030 030 030 030 030 000 000 010 000 000 000 000 000 010 010 010 010 010 000 000 000
091 132 183 111 132 153 030 000 000 000 000 000 000 000 000 000 000 000 000 000 000 000 000