23 14
060 060 030 000 000 000 000 000 000 000 000 030 091 030 060 060 000 000 000 000 000 000 000
060 060 030 000 000 000 000 000 101 132 193 030 132 030 000 000 000 000 000 000 000 000 000
060 060 030 000 000 000 010 000 000 000 000 030 183 030 000 000 000 000 000 000 000 000 000
060 060 030 030 000 000 000 000 000 000 000 030 071 030 000 000 060 000 000 060 000 000 000
060 060 060 030 000 000 000 000 000 000 000 030 132 030 000 000 000 000 000 000 000 000 000
060 060 060 030 030 000 000 000 040 040 040 030 163 030 000 000 000 000 000 000 000 060 000
060 060 060 060 030 000 000 000 000 000 000 030 030 030 000 060 000 060 000 000 000 000 000
060 060 060 060 030 000 000 000 000 000 020 000 000 030 000 000 000 000 000 000 000 000 000
060 060 060 060 030 000 000 000 000 020 000 000 000 030 000 000 000 000 000 000 000 000 000
060 060 030 030 030 040 040 040 040 040 020 030 020 030 000 000 000 000 000 000 000 000 000
060 060 030 000 000 000 000 000 000 020 020 030 000 030 000 000 000 000 000 000 000 000 000
060 060 030 000 081 132 183 000 000 000 000 030 000 020 000 000 030 050 000 111 132 153 000
060 060 030 000 000 000 173 000 000 000 000 030 000 020 000 000 000 000 000 000 000 000 000
060 060 030 000 000 000 000 000 000 020 000 030 030 030 030 000 000 000 000 000 000 000 000
