23 13
000 000 000 000 000 000 000 000 000 000 000 000 000 000 000 000 000 000 000 000 000 000 000
000 000 000 000 000 000 000 000 000 000 000 000 000 000 000 000 000 000 000 000 000 000 000
000 000 000 000 071 132 163 000 000 000 000 000 111 132 153 000 000 000 000 000 000 000 000
000 000 000 000 000 000 000 000 000 000 000 000 000 000 000 000 000 000 000 000 000 000 000
000 000 000 000 030 030 030 030 030 030 030 030 030 030 030 000 000 000 000 000 000 000 000
000 000 000 000 000 000 000 000 000 020 000 000 000 000 000 000 000 000 000 000 000 000 000
000 000 000 000 000 010 000 000 000 020 000 000 000 050 000 000 000 000 000 000 000 000 000
000 000 000 000 000 000 000 000 000 020 000 000 000 000 000 000 000 000 000 000 000 000 000
000 000 000 000 030 030 030 030 030 030 030 030 030 030 030 000 000 000 000 000 000 000 000
000 000 000 000 000 000 000 000 000 000 000 000 000 000 000 000 000 000 000 000 000 000 000
000 000 000 000 091 132 183 000 000 000 000 000 081 132 173 000 000 000 000 000 000 000 000
000 000 000 000 000 000 000 000 000 000 000 000 000 000 000 000 000 000 000 000 000 000 000
000 000 000 000 000 000 000 000 000 000 000 000 000 000 000 000 000 000 000 000 000 000 000