23 13
101 132 213 030 030 030 030 030 030 030 030 030 030 030 030 030 030 030 030 030 000 040 000
030 030 030 030 000 000 000 000 000 000 000 000 000 000 000 000 000 000 000 030 040 050 040
030 000 010 000 000 000 000 000 000 000 010 000 000 000 000 000 000 000 000 030 000 040 000
030 000 000 000 000 000 000 000 000 000 000 000 000 000 000 000 000 000 000 030 030 030 030
030 000 071 000 000 000 000 000 000 000 000 000 000 000 000 000 000 000 000 000 000 000 030
030 000 132 030 000 000 000 000 000 000 000 000 000 000 000 000 000 000 000 000 000 000 030
030 000 163 030 000 000 000 000 000 000 000 000 000 000 000 000 000 000 000 000 000 000 030
030 000 030 030 000 000 000 000 000 000 000 000 000 000 000 000 000 000 000 000 000 000 030
030 000 000 000 000 000 000 000 000 000 000 000 000 000 000 000 000 000 000 000 000 000 030
030 000 000 010 000 000 000 000 000 101 000 000 000 000 000 000 000 000 000 000 000 000 030
030 000 000 000 000 000 010 000 000 000 000 000 000 000 000 000 000 000 000 000 000 000 030
030 030 030 030 030 030 030 000 000 000 000 000 000 000 000 000 000 000 000 000 000 000 030
091 132 183 111 132 153 030 030 030 030 030 030 030 030 030 030 030 030 030 030 030 030 030