26 19
030 030 030 000 030 000 030 000 000 030 000 000 030 000 000 030 000 030 000 030 000 030 030 000 000 000
000 030 000 000 030 030 030 000 030 000 030 000 030 030 000 030 000 030 030 000 000 030 000 000 000 000
000 030 000 000 030 030 030 000 030 030 030 000 030 000 030 030 000 030 030 000 000 000 030 000 000 000
000 030 000 000 030 000 030 000 030 000 030 000 030 000 000 030 000 030 000 030 000 030 030 000 000 000
000 000 000 000 000 000 000 000 000 000 000 000 000 000 000 000 000 000 000 000 000 000 000 000 000 000
000 000 000 000 000 000 000 000 000 000 000 000 000 000 000 000 000 000 000 000 000 000 000 000 000 000
000 000 000 000 000 000 000 000 030 030 030 000 030 030 030 000 030 030 030 000 000 000 000 000 000 000
000 000 000 000 000 000 000 000 030 000 000 000 030 000 030 000 030 000 030 000 000 000 000 000 000 000
000 000 000 000 000 000 000 000 030 030 030 000 030 000 030 000 030 030 030 000 000 000 000 000 000 000
000 000 000 000 000 000 000 000 030 000 000 000 030 030 030 000 030 000 030 000 000 000 000 000 000 000
000 000 000 000 000 000 000 000 000 000 000 000 000 000 000 000 000 000 000 000 000 000 000 000 000 000
000 000 000 000 000 000 000 000 000 000 000 000 000 000 000 000 000 000 000 000 000 000 000 000 000 000
030 030 030 000 030 000 000 000 030 000 000 030 000 030 000 030 000 030 000 000 030 000 030 030 030 000
030 000 030 000 030 000 000 030 000 030 000 000 030 000 000 000 000 030 030 000 030 000 030 000 000 000
030 030 030 000 030 000 000 030 030 030 000 000 030 000 000 030 000 030 000 030 030 000 030 030 030 000
030 000 000 000 030 030 000 030 000 030 000 000 030 000 000 030 000 030 000 000 030 000 030 030 030 000
000 000 000 000 000 000 000 000 000 000 000 000 000 000 000 000 000 000 000 000 000 000 000 000 000 000
000 000 000 000 000 000 000 000 000 000 000 000 000 000 000 000 000 000 000 000 000 000 000 000 000 000
071 132 163 000 000 000 000 000 000 000 000 000 010 050 000 000 000 000 000 000 000 000 000 111 132 153