23 13
111 132 153 000 000 000 000 000 000 000 000 000 000 000 000 000 000 000 000 000 000 000 000
000 000 000 000 000 081 132 173 000 000 020 000 000 000 000 000 000 000 020 000 000 000 000
000 000 000 000 000 000 000 000 000 000 000 000 000 000 000 000 000 000 000 000 000 000 000
000 000 000 030 030 030 030 030 000 000 000 000 000 000 040 040 040 040 040 000 000 000 000
000 000 000 030 000 000 000 030 000 000 000 000 000 000 040 000 000 000 040 000 000 000 000
091 000 000 030 000 010 000 020 000 000 000 000 000 000 040 000 050 000 040 000 000 000 000
132 000 000 030 000 000 000 030 000 000 000 000 000 000 040 000 000 000 040 000 000 000 000
183 000 000 030 030 030 030 030 000 000 000 000 000 000 040 040 040 040 040 000 000 000 000
000 000 000 000 000 000 000 000 000 000 000 000 000 000 000 000 000 000 000 000 000 000 000
000 000 000 000 000 000 000 000 000 000 000 000 000 000 000 000 000 000 000 000 000 000 000
000 000 000 071 132 163 000 000 000 000 020 000 000 000 000 000 000 000 000 000 000 000 000
000 000 000 000 000 000 000 000 000 000 000 000 000 000 000 000 000 000 000 000 000 000 000
000 000 000 000 000 000 000 000 000 000 000 000 000 000 000 000 000 000 000 000 101 132 193