23 14
060 060 000 000 000 000 000 000 030 030 030 030 030 030 030 030 030 030 030 030 030 030 030
060 060 000 000 000 000 000 000 030 010 000 000 000 000 000 000 030 000 000 000 000 000 030
060 060 000 000 000 000 000 000 030 030 030 030 030 030 030 000 030 030 030 030 030 000 030
060 060 000 000 000 000 000 000 030 000 000 000 000 000 030 000 000 000 000 000 030 000 030
060 060 060 000 000 000 000 000 030 000 030 030 030 000 030 030 030 030 030 000 030 000 030
060 060 060 000 071 132 163 000 030 000 030 000 030 000 000 000 000 000 030 000 030 000 030
060 060 060 060 000 000 000 000 030 000 030 000 030 030 000 030 030 030 030 000 030 000 030
060 060 060 060 091 132 183 000 030 000 030 000 000 000 000 000 000 000 000 000 000 000 030
060 060 060 060 000 000 000 000 030 000 030 030 030 030 030 030 030 030 030 030 030 000 030
060 060 000 000 111 132 153 000 030 000 000 000 000 020 000 000 000 000 000 030 030 030 030
060 060 000 000 000 000 000 000 030 000 030 030 020 000 030 030 030 000 000 000 000 000 030
060 060 000 000 081 132 173 000 030 000 030 030 030 030 030 000 030 030 030 000 030 020 030
060 060 000 000 000 000 000 000 030 000 000 000 020 000 000 000 000 000 000 000 030 000 000
060 060 000 000 000 000 000 000 030 030 030 030 030 030 030 030 030 030 030 030 030 000 050