15 10
000 000 000 000 000 000 000 000 000 000 000 000 000 000 000
000 000 000 000 000 000 000 000 000 000 030 030 030 030 000
000 000 000 000 000 000 000 000 000 000 030 000 030 000 000
000 000 071 132 163 000 000 000 000 000 030 000 030 091 000
010 000 000 000 000 000 000 000 000 000 030 000 030 132 000
000 000 111 132 153 000 000 000 000 000 030 050 030 183 000
000 000 000 000 000 000 000 000 000 000 030 000 060 000 000
000 000 000 000 000 000 000 000 000 000 030 000 030 000 000
000 000 000 000 000 000 000 000 000 000 030 030 030 030 000
000 000 000 000 000 000 000 000 000 000 000 000 000 000 000