23 13
060 000 000 000 000 000 000 000 000 000 000 000 000 000 000 000 000 000 000 000 000 000 000
060 060 000 000 000 000 000 000 000 000 000 000 000 000 000 000 000 000 000 000 000 000 000
060 060 060 000 000 000 000 000 000 000 000 000 010 010 010 010 010 010 000 000 000 000 000
060 060 060 000 000 000 000 000 000 000 000 000 010 000 000 000 000 010 000 000 000 000 000
060 060 060 000 000 000 000 000 010 010 010 010 010 132 000 000 000 010 000 000 000 000 000
060 060 060 000 000 000 000 000 010 000 000 000 000 000 000 153 000 010 000 000 000 000 000
060 060 060 000 000 000 000 000 010 000 000 000 000 000 000 000 000 010 000 000 000 000 000
060 060 060 000 000 000 000 000 010 111 000 000 000 050 000 000 000 010 000 000 000 000 000
060 060 060 000 000 000 000 000 010 010 010 010 010 010 010 010 010 010 000 000 000 000 000
060 060 060 000 000 000 000 000 000 000 000 000 010 000 000 000 000 010 000 000 000 000 000
060 060 071 000 000 000 000 000 000 000 000 000 010 010 010 010 010 010 000 000 000 000 000
060 060 132 000 000 000 000 000 000 000 000 000 000 000 000 000 000 000 000 000 000 000 000
060 000 163 000 000 000 000 000 000 000 000 000 000 000 000 000 000 000 000 000 000 000 000
