16 10
111 000 153 020 000 000 000 000 000 000 000 000 000 000 000 000
081 132 153 020 000 000 000 000 000 000 000 000 000 000 000 000
000 000 000 020 000 000 010 000 000 000 000 000 000 000 000 000
000 000 000 020 000 000 000 000 000 000 000 000 000 000 000 000
000 000 000 020 000 000 000 000 000 000 000 000 000 000 000 000
071 132 163 020 000 000 000 000 000 000 000 000 000 000 000 000
071 142 111 020 000 000 000 000 050 000 000 000 000 000 000 000
000 000 000 020 000 000 000 000 000 000 000 000 000 000 000 000
000 000 000 020 000 000 000 000 000 000 000 000 000 000 000 000
000 000 000 020 000 000 000 000 000 000 000 000 000 000 000 000